+-+-+-+-+-+-+-+-+-+-+-+-+-+-+-+-+
| |   |     |                   |
+ +-+ + +-+ + +-+-+-+-+-+-+-+ + +
| |   | |   |       |     |   | |
+ + +-+ + +-+ +-+-+ + +-+ + +-+ +
| |   | |           | | |   |   |
+ +-+ + + +-+-+-+-+-+ + + +-+ + +
| |   | | |         | |       | |
+ + +-+ + + +-+-+-+ + +-+-+-+-+ +
| |     | | |       |   |       |
+ +-+-+-+ + + +-+-+ +-+ + +-+-+ +
|       | | | |         |       |
+-+-+-+ +-+ + + +-+-+-+ +-+-+ +-+
|     | |   | |       |     |   |
+ +-+-+ + +-+-+-+-+-+ +-+-+ +-+ +
| |   | |     |   |         |   |
+ + + + +-+ +-+ + +-+-+-+-+-+ + +
| | | | |         |           | |
+ + + + + +-+-+-+-+ +-+-+-+ +-+ +
| | | | | |   |   |             |
+ + + + + + +-+ + +-+-+-+ +-+ +-+
| |   | | | |   | | |       |   |
+ + + + + + + +-+ + + + +-+-+-+ +
|   | | | | | |   | | |   | |   |
+ + + + + + + + +-+ + +-+ + + +-+
| | | | | | | |     |   |   |   |
+-+ + + + + + + +-+-+-+ + + +-+ +
|   |   |   | | |       | |   | |
+ + +-+-+-+-+-+ + +-+-+-+ + + + +
| |             |         | |   |
+ + +-+-+-+-+-+ +-+-+-+-+-+-+-+ +
| |                             |
.-+-+-+-+-+-+-+-+-+-+-+-+-+-+-+-+
