+-+-+-+-+-+-+-+-+-+-+-+-+-+-+-+-+
|                               |
+ +-+-+-+-+-+ +-+-+-+ +-+-+-+-+ +
|   |                 |         |
+-+ + + +-+-+-+-+-+ +-+ +-+ + + +
|   | |                 |   | | |
+ + + +-+ +-+-+ +-+-+-+ + + + + +
| | | |   |             | | |   |
+ + + + + + +-+-+-+-+-+ + + + + +
|   |   |   |         |   |   | |
+ +-+-+ +-+ + + +-+ + +-+ + + + +
| |   |   | | |     |   | | | | |
+ + + +-+ + + +-+ + + + + + + + +
| | |   | | |     |   | |   | | |
+ + +-+ + + + +-+ + + + + +-+ + +
| |   |     | |   | | | | |   | |
+ +-+ +-+-+-+ + + + + + + + +-+ +
|   | |       |   | |   | | |   |
+ + + + +-+-+ +-+-+ + + + + + +-+
| | | |       |       | |   |   |
+ + + +-+-+-+-+ +-+-+-+ + + + + +
| | |         |         | | | | |
+ + + + +-+-+ +-+-+-+ + + + + + +
|   | |   |           | | | | | |
+ +-+ + + + +-+-+ +-+-+ + + + + +
| |   | |               |   | | |
+ + +-+ + +-+ +-+-+-+-+-+ + + + +
| |   |             |     | |   |
+ +-+ + +-+-+-+-+-+ + +-+-+-+ +-+
|   |   |         |   |         |
+ + +-+-+ +-+-+-+ +-+-+ +-+-+-+ +
| |                             |
.-+-+-+-+-+-+-+-+-+-+-+-+-+-+-+-+
