+-+-+-+-+-+-+-+-+-+-+-+-+-+-+-+-+
|                               |
+ +-+-+-+-+-+-+-+-+-+-+-+-+-+ + +
| |   |       |               | |
+ + + + +-+-+ +-+ +-+-+-+-+-+-+ +
| | | |   |     |     |       | |
+ + + +-+ +-+-+ + +-+ +-+ +-+ + +
| | | | |     | | |     |   | | |
+ + + + +-+-+ + +-+-+ +-+-+ + + +
| | |       | |     |     | | | |
+ + +-+-+-+ + +-+ +-+-+-+ + + + +
| |   | |   |   |     | | | | | |
+ +-+ + + +-+ + +-+ +-+ + + + + +
| | |   |   | |   |     | | | | |
+ + +-+ +-+ + +-+ + + +-+ + + + +
| |   |   |   |   | |   |   | | |
+ + + +-+ +-+ + + + + + +-+-+ + +
| | | |     | |   | | |     | | |
+ + + +-+-+ +-+-+-+ + + + + + + +
| | | |   |     |   |   | | | | |
+ + + + + +-+ +-+-+-+-+-+-+ + + +
| | | | |   |   |     | |   | | |
+ + + + +-+ +-+ + + +-+ +-+ + + +
| | | | |   |     | |     |   | |
+ + + + + +-+-+-+-+ +-+ + +-+ + +
| | | | |           |   | | | | |
+ + + + +-+-+-+-+-+-+ +-+ + +-+ +
|   | |                 |     | |
+ + + +-+-+-+-+-+-+-+-+-+-+-+ + +
| | |                         | |
+ + +-+-+-+-+-+-+-+-+-+-+-+-+-+ +
| |                             |
.-+-+-+-+-+-+-+-+-+-+-+-+-+-+-+-+
