+-+-+-+-+-+-+-+-+-+-+-+-+-+-+-+-+
|   |                           |
+ + + +-+-+-+-+-+-+-+-+-+-+-+-+ +
| | |   |                     | |
+ + + +-+ +-+-+-+-+-+-+-+-+-+ + +
| | | |     |               |   |
+ + + +-+ +-+ +-+-+-+-+-+-+ +-+-+
| | | |     | |           |   | |
+ + + +-+ +-+ + +-+-+-+-+ +-+ + +
| | | |     | |     |     | |   |
+ + + +-+ +-+ +-+-+ +-+ + + + + +
| | | |     | | |   |   | |   | |
+ + + + +-+-+ + + +-+ + +-+ +-+ +
| | | |           |   | |       |
+ + + +-+-+-+ +-+-+ + +-+ +-+ +-+
| | | |   |   |     | |         |
+ + + + + +-+ + + + +-+ +-+-+ +-+
| | | | | |   |   | |     | |   |
+ + + + + + +-+ +-+-+ +-+-+ +-+ +
| | | | |   |     |     |     | |
+ + + + +-+-+ +-+-+ +-+-+ +-+ + +
| | | | | |     |     |     | | |
+ + + + + + +-+-+ +-+-+ + +-+ + +
| | | | |     |     |   |   | | |
+ + + + + +-+-+ +-+-+ +-+-+ + + +
| | | |     |     |     |   | | |
+ + + + +-+-+ +-+-+ +-+ + + + + +
| | | | | |     |     |   | | | |
+ + + +-+ +-+ +-+ + + + + + + + +
| | | |     |     | |   |   | | |
+ + + + +-+ +-+-+-+-+-+-+-+ + + +
| |       |                 |   |
.-+-+-+-+-+-+-+-+-+-+-+-+-+-+-+-+
